d00000000000000
000000000000000
00000000000b000
000000p0o000000
000000000000000
000b00c0i000000
00000000000b000
000000000000000
000b000000b0000
000000000000000
00000000000b000
000b00000000000
000000000000000
000000000000000
00000000000000m
